#############
#       #   #
### ### ### #
#   #       #
# ######### #
#     #   # #
##### ### # #
#   #   #   #
# # ### # ###
# # # # #   #
# # # ##### #
# #       # #
# ##### ### #
# #   # #   #
# # # # # ###
#   # # #   #
# ### ##### #
#   #       #
#############
