#########
#       #
# ### ###
#   #   #
####### #
#       #
# # #####
# # #   #
# ##### #
#     # #
# # ### #
# #     #
#########
