#################
# #         #   #
# # ####### # # #
#   #   #   # # #
# ##### # ##### #
# #     #     # #
# # ### ##### # #
# # # # #     # #
# # # # # ##### #
#   # # # #     #
##### # ### ### #
#     #   # #   #
# # ##### # # ###
# # #   #   # # #
# # # # ##### # #
# #   #         #
#################
