#####################
#   #     #   #     #
# # # ### # # # # # #
# #   # #   #   # # #
##### # ######### # #
#   #   #     #   # #
# # ##### ### # #####
# #       # # #     #
# ### ##### # ##### #
# #   #     #     # #
# ##### ######### # #
#     #   #       # #
# ### ### # ####### #
#   #     #         #
#####################
