###############################
#   #           #       #     #
# # # ### ##### ##### ### # ###
# # # # #     #     #     #   #
# # # # ##### ##### # ####### #
# # # #   #   #   # #   #     #
# ### # ### # ### # ##### #####
#   # # #   #   # # #   #     #
# # # # # ####### # # # ##### #
# #     #         #   #       #
###############################
